############################
#............##............#
#.####.##.##.##.##.##.####.#
#......##.##.##.##.##......#
######.##.##.##.##.##.######
      .##.##.##.##.##.      
######.##.##.##.##.##.######
#......##.##.##.##.##......#
#O####.##....##....##.####O#
#.####.##### ## #####.####.#
#......##### ## #####......#
###.##.##          ##.##.###
  #.##.## ###--### ##.##.#  
  #.##.## #      # ##.##.#  
  #.##.   #      #   .##.#  
  #.##.## #      # ##.##.#  
  #.##.## ######## ##.##.#  
  #.##.##          ##.##.#  
  #.##.## ######## ##.##.#  
###.##.## ######## ##.##.###
#............##............#
#.####.#####.##.#####.####.#
#.####.#####.##.#####.####.#
#............ .............#
######.##.########.##.######
      .##.########.##.      
######.##....##....##.######
#......#####.##.#####......#
#.##########.##.##########.#
#O........................O#
############################