############################
#............##...........O#
#.####.#####.##.#####.####.#
#.####.#####.##.#####.####.#
#.####.#####.##.#####.####.#
#..........................#
#.####.##.########.##.####.#
#.####.##.########.##.####.#
#......##....##....##......#
#.####.##### ## #####.####.#
#.####.##### ## #####.####.#
#......              ......#
######.## ###--### ##.######
#...##.## #      # ##.##...#
#O#....## #      # ##....#O#
#...##.## #      # ##.##...#
######.## ######## ##.######
#......              ......#
#.####.## ######## ##.####.#
#.####.## ######## ##.####.#
#............##............#
#.####.#####.##.#####.####.#
#.####.#####.##.#####.####.#
#...##....... ........##...#
###.##.##.########.##.##.###
###.##.##.########.##.##.###
#......##....##....##......#
#.##########.##.##########.#
#.##########.##.##########.#
#O.........................#
############################